1111111111111
1C110000C0C01
1000011111001
1P0011E000001
1111111111111